19
20
00 06 06 06 06 06 06 06 06 06 06 06 06 06 06 06 06 06 01
04 88 88 88 88 88 88 88 88 88 88 88 88 88 88 88 88 88 05
25 14 14 14 14 14 14 14 14 14 14 14 14 14 14 14 18 88 05
04 88 88 88 88 88 88 88 88 88 88 88 88 88 88 88 13 88 05
04 88 17 14 14 14 14 14 14 14 14 14 14 14 18 88 13 88 05
04 88 13 88 88 88 88 88 88 88 88 88 88 88 13 88 13 88 05
04 88 13 88 17 14 14 14 14 14 14 14 18 88 13 88 13 88 05
04 88 13 88 13 88 88 88 88 88 88 88 13 88 13 88 13 88 05
04 88 13 88 13 88 17 14 14 14 18 88 13 88 13 88 13 88 05
04 88 13 88 13 88 13 88 88 88 13 88 13 88 13 88 13 88 05
04 88 13 88 13 88 13 88 09 88 13 88 13 88 13 88 13 88 05
04 88 13 88 13 88 13 88 15 14 16 88 13 88 13 88 13 88 05
04 88 13 88 13 88 13 88 88 88 88 88 13 88 13 88 13 88 05
04 88 13 88 13 88 15 14 14 14 14 14 16 88 13 88 13 88 05
04 88 13 88 13 88 88 88 88 88 88 88 88 88 13 88 13 88 05
04 88 13 88 15 14 14 14 14 14 14 14 14 14 16 88 13 88 05
04 88 13 88 88 88 88 88 88 88 88 88 88 88 88 88 13 88 05
04 88 15 14 14 14 14 14 14 14 14 14 14 14 14 14 16 88 05
04 88 88 88 88 88 88 88 88 88 88 88 88 88 88 88 88 88 05
02 07 07 07 07 07 07 07 07 07 07 07 07 07 07 07 07 07 03
01 01
01 01
01 01
01 01