36
18
00 06 06 06 06 06 06 06 06 06 26 06 06 26 06 06 06 06 06 06 06 06 06 26 26 06 06 06 26 06 06 26 06 06 06 01
04 28 88 88 88 88 88 88 88 88 15 14 14 16 88 88 88 88 88 88 88 88 88 15 16 88 88 88 13 88 88 13 88 88 88 05
04 88 88 17 14 14 14 11 88 88 88 88 88 88 88 88 09 88 88 88 09 88 88 88 88 88 88 88 15 11 88 10 88 08 88 05
04 88 88 13 88 88 88 88 88 88 88 88 88 88 88 88 13 88 88 88 13 88 88 17 14 11 88 88 88 88 88 88 88 88 88 05
04 88 88 13 88 88 88 88 88 88 17 14 14 18 88 88 13 88 88 88 13 88 88 13 88 88 88 88 12 14 11 88 12 18 88 05
25 18 88 13 88 12 14 18 88 88 13 28 28 13 88 88 13 88 17 14 23 88 88 15 14 18 88 88 88 88 88 88 88 13 88 05
25 16 88 13 88 88 88 13 88 88 13 28 28 13 88 88 13 88 13 28 13 88 88 88 88 13 88 88 09 88 17 14 22 16 88 05
04 88 88 15 14 14 14 16 88 88 15 14 14 16 88 88 10 88 15 14 16 88 88 12 14 16 88 88 10 88 10 88 10 88 88 05
04 88 88 88 88 88 88 88 88 88 88 88 88 88 88 88 88 88 88 88 88 88 88 88 88 88 88 88 88 88 88 88 88 88 88 05
25 22 11 88 88 88 88 88 88 88 88 88 12 14 22 14 14 14 14 14 14 11 88 88 88 88 88 88 09 88 88 09 88 12 14 27
25 16 88 88 88 88 88 88 88 88 09 88 88 88 10 88 88 88 88 88 88 88 88 88 08 88 88 88 13 88 88 13 88 88 88 05
04 88 88 17 14 14 11 88 88 88 13 88 88 88 88 88 09 88 08 88 08 88 88 88 88 88 88 88 13 88 12 19 11 88 88 05
04 88 88 13 88 88 88 88 88 88 21 14 14 18 88 88 21 11 88 09 88 09 88 88 09 88 17 14 23 88 88 13 88 88 88 05
25 11 88 13 88 88 88 88 88 88 13 88 88 13 88 88 13 88 88 13 88 13 88 88 13 88 13 28 13 88 88 13 88 88 88 05
04 88 88 15 14 14 11 88 88 88 10 88 88 10 88 88 10 88 88 10 88 10 88 88 10 88 15 14 16 88 88 15 11 88 88 05
04 88 88 88 88 88 88 88 09 88 88 88 88 88 88 88 88 88 88 88 88 88 88 88 88 88 88 88 88 88 88 88 88 88 88 05
04 88 88 88 17 14 18 88 21 18 88 88 88 88 17 18 88 88 09 88 88 88 17 18 88 88 88 88 88 09 88 88 88 88 88 05
02 07 07 07 24 07 24 07 24 24 07 07 07 07 24 24 07 07 24 07 07 07 24 24 07 07 07 07 07 24 07 07 07 07 07 03
34 16
01 16
19 11
34 01